
[MAP_DATA]
1, 1, 1, 1, 1, 1, 1, 1, 1, 1, 1,
1, 0, 0, 0, 0, 0, 0, 0, 0, 0, 1,
1, 0, 0, 0, 0, 3, 0, 0, 0, 0, 1,
1, 0, 0, 0, 0, 0, 0, 0, 0, 0, 1,
1, 0, 2, 0, 4, 4, 0, 0, 0, 0, 1,
1, 0, 0, 0, 4, 0, 0, 0, 0, 0, 1,
1, 0, 2, 0, 0, 0, 0, 0, 0, 0, 1,
1, 0, 1, 1, 0, 0, 1, 0, 0, 0, 1,
1, 0, 0, 0, 0, 0, 0, 0, 0, 0, 1,
1, 0, 0, 0, 0, 0, 0, 0, 0, 0, 1,
1, 1, 1, 1, 1, 1, 1, 1, 1, 1, 1,

[SPRITES_DATA]
{20.5, 11.5, 10},
{18.5,4.5, 10},
{10.0,4.5, 10},
{10.0,12.5,10},
{3.5, 6.5, 10},
{3.5, 20.5,10},
{3.5, 14.5,10},
{14.5,20.5,10},
{18.5, 10.5, 9},
{18.5, 11.5, 9},
{18.5, 12.5, 9},
{21.5, 1.5, 8},
{15.5, 1.5, 8},
{16.0, 1.8, 8},
{16.2, 1.2, 8},
{3.5,  2.5, 8},
{9.5, 15.5, 8},
{10.0, 15.1,8},
{10.5, 15.8,8},
